################################
#                              #
#                              #
#                              #
#                              #
#                              #
#                              #
#                              #
#                              #
#     &&&&&  &&&  &&           #
#                              #
#                    &&&&      #
#            &&&&&             #
#                              #
#      &&&&     &&&&&&         #
#                              #
#&&&&               &&&&&      #
#                              #
#      &&&&&&&                 #
#                              #
#                &&&&&         #
#                              #
#    &&&&&  &&&&               #
#                              #
#&&&                         ! #
####&&&&&&&&&&&&&&&&&&&&&&&&&&&#
################################
