#                                                                                 #
#                                                                                 #
#                                                                                 #
#                                                                                 #
#                                                                                 #
#                                                                                 #
#                                                                                 #
#                                                                                 #
#                                                                                 #
#                                                                                 #
#                                                                                 #
#                                                                                 #
#"""""""""""""""""""""""""""""""""""""""""""""""""""""""""""""""""""""""""""""""""#
###################################################################################
