#                                                                                 #
#                                                                                 #
#                                                                                 #
#                                                                                 #
#                                                                                 #
#                                                                                 #
#                                                                                 #
#                                                                                 #
#                                                                                 #
#                                                                                 #
#                                                                                 #
#                                                                                 #
#&&&&&&&&&&&&&&&&&&&&&&&&&&&&&&&&&&&&&&&&&&&&&&&&&&&&&&&&&&&&&&&&&&&&&&&&&&&&&&&&&#
###################################################################################
